..SFFFFFFFFAFFFF.
......FF......FF.
......FF......FF.
..............FF.
..............FF.
.FFF..FFaaFBFFFF.
.FTF..FF.........
.FFF..FF.........
..FFcbFF.........
......FFFFFCFFF..