....FFFFFOOFFFF..
....FTFF.....OF..
....FFF......OF1.
........OFFbbFFF.
...S....OO.....F.
..FBO...OO.....F.
.OOOO...FFb..bFF.
.OOOFOFOOFO..0Fa.
.FOOOOOOOOOOOF...
..OFOOO..OOOOF...
