..................
..................
..................
........SFF.......
........FFF.......
........FTF.......
........FFF.......
..................
..................
..................

