...BFFF...Fbb3...
......F...F......
......FFFFF......
.5aaFFFFSFFFFcc4.
......FFFFF......
......dF..F......
......dF..FFFA...
.FFF..FF..F......
.FTFffF...F......
.FFFe.....FFFC...