.......FFFFFFF...
.FFFF..FFF..FF...
.FFFFFFFFF..FFFF.
.FSFF.......FFTF.
.FFFF.......FFFF.
..............FF.
