.........FFFF....
.........FFFF....
.FFF.....F..FFFF.
.FFFFFFFFF...FTF.
.FSF....FF0..FFF.
.FFF....FFF..FFF.
..FFa...F........
...FFFFFF........
.................