.........FFb.....
........FFF......
.FF..FFFFFF......
.FSFFFF..F.......
.FFFF....F...FFF.
..FF.....AFFFFTF.
...F.....1F..FFF.
...FFF...FF......
....FFF..FF......
....aFFFFFF.....