.................
..FFFOFFFFOFFFF..
..FF........FFF..
..FF.........FFF.
..FFF...FFF..FSF.
..FFFOOOFTF..FFF.
..FFF..OFFF..F...
....F..OOOOOFF...
....FFFOOFOOO....
.....FFOOOOOO....
.....FFF..FF.....

