....OOOOOOO......
....OOOOOOO......
.FFFF.....FFF....
.FFF.......FF....
.FFF.......FF....
.FSF..FFFFOOOOO..
.FFF..FTFFOOOOO..
......FFF..OOFO..
......FFF..OOOO..